R 800 600

NO       ./textures/rainbow.xpm         
SO  ./textures/metal.xpm            
EA   ./textures/tiger.xpm      
WE    ./textures/wood.xpm
S    ./textures/cactus.xpm

  F   255,   255    ,     255    


                   C 80, 80, 200


11111111111111111111111111111111111111111111111111
1E010001000100000010000000000000000000100000000111
10010001000100000000000000010000000000100000000111
10111011101100111110111111111011111111111111111111
10101010101000101010101010101010101010101010101001
10101000000010101010101010101010101010101010101001
10001010101010101010101010101010101010101010101001
11101011111011111110111111111011111111111111111111
12000000000000002200111111110000000000020020022001
12000000000002200000111111110000000000020200000001
12000002000002200000000000000000000000002000000001
10200000000000000000000000000000000000000000000001
10020000002000000000111111110000000200000000000001
10000000000000002000111111110200002200000000002001
11111110000111111111111111111111111111111111111111
11000000000000000000000000000002111111111111000021
11000000000000000000000011111100000000000000021111
11111111111111111111111111111111111111111111111111
