R 800 600
NO ./pics/bluestone.png  
SO ./pics/redbrick.png  
WE ./pics/wood.png  
EA ./pics/wood.png  
S  ./pics/doll.png  
F 32,70,74
C 33,32,74

11111111111111111111111111111111111111111
11001000000000121000000000221110000000001
10000000000000101000002000221110000000001
10000000010000101200000000001110000000001
10200000012000101002020000001110000000001
10000000010000101020200000001110000000001
100000000100001012020000000W1110000000001
10000000010000101020000000000000000000001
10000000210000121000000000000000000000001
10000000010000101000000000001110000000001
10000000010000101022000000001110000000001
10000000010000101022000000001110000000001
11000000010000101000000000001110000000001
10000000010000101000022000201110000000001
11000000010000001200022000001110000000001
10000000110000000000200002001110000000001
11001000010000101000222222201110000000001
11111111111111111111111111111111111111111
