  R   800   600

F 200,102,0

C   25,  102,                                                   66

1  1111111111111111111111111111111111111111
10000000000000101200000000001112000000001
10000000000000101000000000001110000000001
100  00000010000101000000000001110000000001
10000000010000101000000000001110000000001
10000000010000101000000000001110000000001
10000000010000101000000000001110000000001
10000000010000101000000000000000000000001
10000  000010000101000000000000000000000001
10002000010000101000000000001110000000001
10000000010000101000000000001110000000001
10000000010000101000000000001110000000001
  11000000010000101000000000001110000000001
10000000010000101000000000001110000000001
1000W000010000001000000000001110000000001
1000000    0010000000000000000001110000000001
10000000012000101000000000001110000200001
  11111111111   111111111111111111111111111111
