R 800 600

F 200,102,0

C   25,  102,                                                   66

11111111111111111111111111111111111111111
11001000000000101200000000001112000000001
10000000000000101000000000001110000000001
10000000010000101000000000001110000000001
10000000010000101000000000001110000000001
10000000010000101000000000001110000000001
10000000010000101000000000001110000000001
10000000010000101000000000000000000000001
10000000010000101000000000000000000000001
10002000010000101000000000001110000000001
10000000010000101000000000001110000000001
10000000010000101000000000001110000000001
11000000010000101000000000001110000000001
1000000E010000101000000000001110000000001
11000000010000001000000000001110000000001
10000000110000000000000000001110000000001
11001000012000101000000000001110000200001
11111111111111111111111111111111111111111
