R 800 600
NO ./pics/bluestone.png  
SO ./pics/colorstone.png  
WE ./pics/purplestone.png  
EA ./pics/eagle.png  
S  ./pics/doll.png  
F 0,255,0
C 0,255,255

11111111111111111111111111111111111111111
11001000000000101200000000001112000000001
10000000000000101000000000001110000000001
10000000010000101000000000001110000000001
10000000010000101000000000001110000000001
10000000010000101000000000001110000000001
10000000010000101000000000001110000000001
10000000010000101000000000000000000000001
1000N000010000101000000000000000000000001
10000000010000101000000000001110000000001
10000000010000101000000000001110000000001
10000000010000101000000000001110000000001
11000000010000101000000000001110000000001
10000000010000101000000000001110000000001
11000000010000001000000000001110000000001
10000000110000000000000000001110000000001
11001000012000101000000000001110000200001
11111111111111111111111111111111111111111
