11111111111111111111111111111111111111111
10000000000000101200000000001112000000001
10000000000000101000000000001110000000001
10000000010000101000000000001110000000001
10000000010000101000000000001110000000001
10000000010000101000000000001110000000001
10000000010000101000000000001110000000001
10000000010000101000000000000000000000001
10000000010000101000000000000000000000001
10002000010000101000000000001110000000001
10000000010000101000000000001110000000001
10000000010000101000000000001110000000001
10000000010000101000000000001110000000001
10000000010000101000000000001110000000001
1000N000010000001000000000001110000000001
10000000010000000000000000001110000000001
10000000012000101000000000001110000200001
10111111111111111111111111111111111111111
